111111111111111111
11C001C00100110C11
100111100100011011
100000101110000011
11P010000C00011111
10C011011000000111
101111E011C1110C11
101111101100111001
10001000C110111101
11000CE0001E1C0001
111111111111111111